11111111111111111111
10000000000000000001
10111111111101110101
10000000000100100101
11111111010110101111
10000010010010000001
11011010111010101111
20010000000000100001
11010101011111111101
10010100010000000101
10110111010111110101
10000001010100010101
11110101010101000101
10000101110101111101
10110100000000000001
10100111111111011101
10100000000000010101
10111011111111011101
10001000000001000001
11111111111111111111