11111111111111111111111111111111111111111111111
10001000101000000001010000010000000100001000101
10101010001010111101010111010111110101101010101
10101110111010000101000100000100010100100010101
10100000100011110101111101111101010110111110101
10111111101110010101000001000001010000100000101
10001000001111010101011111011111010111101111101
10101011111000010101010000010000010010101000101
10100000000011110101011101111111111010101010101
10111111111110000100010000000100001010100010101
10111111111110111111110111110101101010111110101
10100000100000100000000000010101001010001010001
10111110101111101101111111010101011011101010111
10100010100000100100000001010001010010100010001
10101010111110101111111101011111011110101111101
10101010010000100001000001000001000000100000101
10101011010111111101011111111101111101111110101
10101000010000000001000000010001000101000010001
10101111111111111111011111011111010111011011111
10100000010000100001010001000000010001010010001
10111111011110111101010101111111111101011110101
10010000000000000001010100100010000001001000101
11010111111111111111010101101010111111101011101
10010000000000001000010100101010000000001000101
10111111111111101011111110101011111111111110101
10100000000000001000000000101010000001001000101
10101111111111111111011111101110111101101011101
10001000100000000001000000001000100001001010001
11111010101111111101011111111011101111011010111
10000010100000001001010000000010000000010010001
10111110111111101011010111110111011111110111111
10100000000000001001010100010111000000000100001
10101111111111111111010101011111011111111101101
10100000100000000001010101010001000100000121001
11111110101111111101010101011101110101110111011
10000000100000000001010001000001000100010000011
10111111111111111101011111111111011111011111101
10000000000000000100000000000000000000000000001
11111111111111111111111111111111111111111111111